八	ba	bā
叭	ba	bā
巴	ba	bā
爸	ba	bà
宝	bao	bǎo
饼	bing	bǐng
伯	bo	bó
膊	bo	bó
不	bu	bù
查	cha	chá
场	chang	chǎng
吵	chao	chǎo
辰	chen	chén
承	cheng	chéng
酬	chou	chóu
楚	chu	chǔ
袋	dai	dài
铛	dang	chēng
叨	dao	dāo
弟	di	dì
掇	duo	duō
朵	duo	duǒ
儿	er	ér
发	fa	fā
烦	fan	fán
坊	fang	fāng
方	fang	fāng
分	fen	fēn
傅	fu	fù
夫	fu	fū
服	fu	fú
父	fu	fù
腐	fu	fǔ
袱	fu	fú
负	fu	fù
干	gan	gàn
个	ge	gè
哥	ge	gē
搁	ge	gē
公	gong	gōng
狗	gou	gǒu
咕	gu	gū
姑	gu	gū
股	gu	gǔ
蝈	guo	guō
害	hai	hài
罕	han	hǎn
合	he	hé
和	he	hé
喝	he	hē
荷	he	hé
候	hou	hòu
呼	hu	hū
唬	hu	hǔ
户	hu	hù
糊	hu	hú
虎	hu	hǔ
话	hua	huà
伙	huo	huǒ
火	huo	huǒ
箕	ji	jī
甲	jia	jiǎ
教	jiao	jiào
姐	jie	jiě
结	jie	jié
睛	jing	jīng
究	jiu	jiū
舅	jiu	jiù
矩	ju	jǔ
拉	la	lā
栏	lan	lán
唠	lao	láo
姥	lao	lǎo
勒	lei	lè
李	li	lǐ
狸	li	lí
璃	li	lí
里	li	lǐ
亮	liang	liàng
粱	liang	liáng
量	liang	liàng
聊	liao	liáo
咙	long	lóng
芦	lu	lú
轳	lu	lú
罗	luo	luó
落	luo	luò
妈	ma	mā
妹	mei	mèi
没	mo	méi
磨	mo	mó
奶	nai	nǎi
囊	nang	náng
囔	nang	nāng
娘	niang	niáng
扭	niu	niǔ
耙	pa	bà
婆	po	pó
气	qi	qì
荠	qi	jì
欠	qian	qiàn
跷	qiao	qiāo
趄	qie	jū
情	qing	qíng
嚷	rang	rāng
丧	sang	sàng
上	shang	shàng
婶	shen	shěn
声	sheng	shēng
生	sheng	shēng
甥	sheng	shēng
实	shi	shí
拾	shi	shí
识	shi	shí
叔	shu	shū
数	shu	shù
思	si	sī
嗦	suo	suō
嗒	ta	dā
沓	ta	tà
弹	tan	dàn
堂	tang	táng
桃	tao	táo
腾	teng	téng
笹	ti	shì
挑	tiao	tiǎo
同	tong	tóng
头	tou	tóu
涂	tu	tú
饨	tun	tún
娃	wa	wá
猬	wei	wèi
梧	wu	wú
息	xi	xī
西	xi	xī
下	xia	xià
谢	xie	xiè
婿	xu	xù
爷	ye	yé
宜	yi	yí
意	yi	yì
应	ying	yìng
蝇	ying	yíng
友	you	yǒu
元	yuan	yuán
咤	zha	zhà
蚱	zha	zhà
执	zhi	zhí
住	zhu	zhù
子	zi	zǐ